..#.........
..#..#######
..#.....#...
###########.
...#........
