............................................................
.##.........######..........................................
..##.........########................................####...
...........###....###..............................####.....
.........####.....####...............#########....###.......
...##......##########.....................####..####........
..####.........#####........................######..........
..################..........................................
...###...##########.........................................
..####.......#######............................#...........
..####......####...............................#............
..##......####..................#####.......................
............####...........############.....................
.........##########........############.....................
.......###########..........................................
............................................................
............................................................
.....................................################.......
....................................###################.....
............................................................
