00000000
000aaa00
00b00000
00b00000
00b00000
00b00000
00000cc0
00000000
