00b00000
00b00000
00b00aaa
00b00000
00000000
00000000
00000000
00000000
